日期,确诊总数,今日确诊数,治愈总数,治愈新增,现存感染数,现存增加数,死亡人数,新增死亡,高风险地区数,中风险地区数,疑似总数,新增疑似
20200122,1,1,0,0,1,1,0,0,0,0,0,0
20200123,9,8,0,0,9,8,0,0,0,0,0,0
20200124,18,9,1,1,17,8,0,0,0,0,0,0
20200125,31,13,1,0,30,13,0,0,0,0,0,0
20200126,47,16,1,0,46,16,0,0,0,0,0,0
20200127,70,23,1,0,69,23,0,0,0,0,0,0
20200128,99,29,1,0,98,29,0,0,0,0,0,0
20200129,129,30,1,0,128,30,0,0,0,0,0,0
20200130,168,39,2,1,166,38,0,0,0,0,0,0
20200131,202,34,5,3,197,31,0,0,0,0,0,0
20200201,236,34,6,1,230,33,0,0,0,0,0,0
20200202,271,35,7,1,264,34,0,0,0,0,0,0
20200203,308,37,8,1,300,36,0,0,0,0,0,0
20200204,341,33,13,5,328,28,0,0,0,0,0,0
20200205,373,32,26,13,347,19,0,0,0,0,0,0
20200206,408,35,38,12,370,23,0,0,0,0,0,0
20200207,439,31,43,5,396,26,0,0,0,0,0,0
20200208,468,29,51,8,417,21,0,0,0,0,0,0
20200209,492,24,72,21,420,3,0,0,0,0,0,0
20200210,515,23,84,12,431,11,0,0,0,0,0,0
20200211,543,28,94,10,449,18,0,0,0,0,0,0
20200212,570,27,131,37,439,-10,0,0,0,0,0,0
20200213,593,23,137,6,456,17,0,0,0,0,0,0
20200214,604,11,160,23,444,-12,0,0,0,0,0,0
20200215,617,13,190,30,427,-17,0,0,0,0,0,0
20200216,626,9,226,36,400,-27,0,0,0,0,0,0
20200217,629,3,263,37,366,-34,0,0,0,0,0,0
20200218,631,2,296,33,335,-31,0,0,0,0,0,0
20200219,631,0,325,29,306,-29,0,0,0,0,0,0
20200220,631,0,352,27,279,-27,0,0,0,0,0,0
20200221,631,0,387,35,244,-35,0,0,0,0,0,0
20200222,631,0,411,24,220,-24,0,0,0,0,0,0
20200223,631,0,427,16,204,-16,0,0,0,0,0,0
20200224,631,0,458,31,173,-31,0,0,0,0,0,0
20200225,631,0,463,5,168,-5,0,0,0,0,0,0
20200226,631,0,494,31,137,-31,0,0,0,0,0,0
20200227,631,0,506,12,125,-12,0,0,0,0,0,0
20200228,631,0,519,13,112,-13,0,0,0,0,0,0
20200229,631,0,529,10,102,-10,0,0,0,0,0,0
20200301,631,0,536,7,95,-7,0,0,0,0,0,0
20200302,631,0,555,19,76,-19,0,0,0,0,0,0
20200303,631,0,565,10,66,-10,0,0,0,0,0,0
20200304,631,0,580,15,51,-15,0,0,0,0,0,0
20200305,631,0,588,8,43,-8,0,0,0,0,0,0
20200306,631,0,601,13,30,-13,0,0,0,0,0,0
20200307,631,0,610,9,21,-9,0,0,0,0,0,0
20200308,631,0,618,8,13,-8,0,0,0,0,0,0
20200309,631,0,622,4,9,-4,0,0,0,0,0,0
20200310,631,0,627,5,4,-5,0,0,0,0,0,0
20200311,631,0,628,1,3,-1,0,0,0,0,0,0
20200312,631,0,630,2,1,-2,0,0,0,0,0,0
20200313,631,0,630,0,1,0,0,0,0,0,0,0
20200314,631,0,631,1,0,-1,0,0,0,0,0,0
20200315,631,0,631,0,0,0,0,0,0,0,0,0
20200316,631,0,631,0,0,0,0,0,0,0,0,0
20200317,631,0,631,0,0,0,0,0,0,0,0,0
20200318,631,0,631,0,0,0,0,0,0,0,0,0
20200319,631,0,631,0,0,0,0,0,0,0,0,0
20200320,631,0,631,0,0,0,0,0,0,0,0,0
20200321,633,2,631,0,2,2,0,0,0,0,0,0
20200322,633,0,631,0,2,0,0,0,0,0,0,0
20200323,636,3,631,0,5,3,0,0,0,0,0,0
20200324,638,2,631,0,7,2,0,0,0,0,0,0
20200325,640,2,631,0,9,2,0,0,0,0,0,0
20200326,641,1,631,0,10,1,0,0,0,0,0,0
20200327,641,0,631,0,10,0,0,0,0,0,0,0
20200328,644,3,631,0,13,3,0,0,0,0,3,3
20200329,645,1,631,0,14,1,0,0,0,0,3,0
20200330,646,1,631,0,15,1,0,0,0,0,3,0
20200331,646,0,631,0,15,0,0,0,0,0,3,0
20200401,647,1,631,0,16,1,0,0,0,0,3,0
20200402,651,4,632,1,19,3,0,0,0,0,0,-3
20200403,651,0,632,0,19,0,0,0,0,0,0,0
20200404,651,0,633,1,18,-1,0,0,0,0,3,3
20200405,651,0,633,0,18,0,0,0,0,0,3,0
20200406,651,0,633,0,18,0,0,0,0,0,3,0
20200407,651,0,633,0,18,0,0,0,0,0,0,-3
20200408,651,0,633,0,18,0,0,0,0,0,0,0
20200409,651,0,634,1,17,-1,0,0,0,0,3,3
20200410,652,1,636,2,16,-1,0,0,0,0,3,0
20200411,653,1,638,2,15,-1,0,0,0,0,3,0
20200412,653,0,638,0,15,0,0,0,0,0,3,0
20200413,653,0,641,3,12,-3,0,0,0,0,3,0
20200414,653,0,642,1,11,-1,0,0,0,0,3,0
20200415,653,0,642,0,11,0,0,0,0,0,3,0
20200416,653,0,643,1,10,-1,0,0,0,0,3,0
20200417,653,0,643,0,10,0,0,0,0,0,3,0
20200418,653,0,643,0,10,0,0,0,0,0,3,0
20200419,653,0,643,0,10,0,0,0,0,0,3,0
20200420,653,0,644,1,9,-1,0,0,0,0,3,0
20200421,653,0,645,1,8,-1,0,0,0,0,3,0
20200422,653,0,645,0,8,0,0,0,0,0,3,0
20200423,653,0,646,1,7,-1,0,0,0,0,3,0
20200424,653,0,646,0,7,0,0,0,0,0,3,0
20200425,653,0,646,0,7,0,0,0,0,0,3,0
20200426,653,0,646,0,7,0,0,0,0,0,3,0
20200427,653,0,646,0,7,0,0,0,0,0,3,0
20200428,653,0,647,1,6,-1,0,0,0,0,3,0
20200429,653,0,648,1,5,-1,0,0,0,0,3,0
20200430,653,0,650,2,3,-2,0,0,0,0,3,0
20200501,653,0,650,0,3,0,0,0,0,0,3,0
20200502,653,0,650,0,3,0,0,0,0,0,3,0
20200503,653,0,650,0,3,0,0,0,0,0,3,0
20200504,653,0,650,0,3,0,0,0,0,0,3,0
20200505,653,0,650,0,3,0,0,0,0,0,3,0
20200506,653,0,651,1,2,-1,0,0,0,0,3,0
20200507,653,0,652,1,1,-1,0,0,0,0,3,0
20200508,653,0,652,0,1,0,0,0,0,0,3,0
20200509,653,0,652,0,1,0,0,0,0,0,3,0
20200510,653,0,653,1,0,-1,0,0,0,0,3,0
20200511,653,0,653,0,0,0,0,0,0,0,3,0
20200512,653,0,653,0,0,0,0,0,0,0,3,0
20200513,653,0,653,0,0,0,0,0,0,0,3,0
20200514,653,0,653,0,0,0,0,0,0,0,3,0
20200515,653,0,653,0,0,0,0,0,0,0,3,0
20200516,653,0,653,0,0,0,0,0,0,0,3,0
20200517,653,0,653,0,0,0,0,0,0,0,3,0
20200518,653,0,653,0,0,0,0,0,0,0,3,0
20200519,653,0,653,0,0,0,0,0,0,0,3,0
20200520,653,0,653,0,0,0,0,0,0,0,3,0
20200521,653,0,653,0,0,0,0,0,0,0,3,0
20200522,653,0,653,0,0,0,0,0,0,0,3,0
20200523,653,0,653,0,0,0,0,0,0,0,3,0
20200524,653,0,653,0,0,0,0,0,0,0,3,0
20200525,653,0,653,0,0,0,0,0,0,0,3,0
20200526,653,0,653,0,0,0,0,0,0,0,3,0
20200527,653,0,653,0,0,0,0,0,0,0,3,0
20200528,653,0,653,0,0,0,0,0,0,0,3,0
20200529,653,0,653,0,0,0,0,0,0,0,3,0
20200530,653,0,653,0,0,0,0,0,0,0,3,0
20200531,653,0,653,0,0,0,0,0,0,0,3,0
20200601,653,0,653,0,0,0,0,0,0,0,3,0
20200602,653,0,653,0,0,0,0,0,0,0,3,0
20200603,653,0,653,0,0,0,0,0,0,0,3,0
20200604,653,0,653,0,0,0,0,0,0,0,3,0
20200605,653,0,653,0,0,0,0,0,0,0,3,0
20200606,653,0,653,0,0,0,0,0,0,0,3,0
20200607,653,0,653,0,0,0,0,0,0,0,3,0
20200608,653,0,653,0,0,0,0,0,0,0,3,0
20200609,653,0,653,0,0,0,0,0,0,0,3,0
20200610,653,0,653,0,0,0,0,0,0,0,3,0
20200611,653,0,653,0,0,0,0,0,0,0,3,0
20200612,653,0,653,0,0,0,0,0,0,0,3,0
20200613,653,0,653,0,0,0,0,0,0,0,3,0
20200614,653,0,653,0,0,0,0,0,0,0,3,0
20200615,653,0,653,0,0,0,0,0,0,0,3,0
20200616,653,0,653,0,0,0,0,0,0,0,3,0
20200617,653,0,653,0,0,0,0,0,0,0,3,0
20200618,653,0,653,0,0,0,0,0,0,0,3,0
20200619,653,0,653,0,0,0,0,0,0,0,3,0
20200620,653,0,653,0,0,0,0,0,0,0,3,0
20200621,653,0,653,0,0,0,0,0,0,0,3,0
20200622,654,1,653,0,1,1,0,0,0,0,3,0
20200623,654,0,653,0,1,0,0,0,0,0,3,0
20200624,654,0,653,0,1,0,0,0,0,0,3,0
20200625,654,0,653,0,1,0,0,0,0,0,3,0
20200626,654,0,653,0,1,0,0,0,0,0,3,0
20200627,654,0,653,0,1,0,0,0,0,0,3,0
20200628,654,0,653,0,1,0,0,0,0,0,3,0
20200629,654,0,653,0,1,0,0,0,0,0,3,0
20200630,654,0,654,1,0,-1,0,0,0,0,3,0
20200701,654,0,653,-1,1,1,0,0,0,0,3,0
20200702,654,0,653,0,1,0,0,0,0,0,3,0
20200703,654,0,653,0,1,0,0,0,0,0,3,0
20200704,654,0,653,0,1,0,0,0,0,0,3,0
20200705,654,0,653,0,1,0,0,0,0,0,3,0
20200706,654,0,653,0,1,0,0,0,0,0,3,0
20200707,654,0,654,1,0,-1,0,0,0,0,3,0
20200708,654,0,654,0,0,0,0,0,0,0,3,0
20200709,654,0,654,0,0,0,0,0,0,0,3,0
20200710,654,0,654,0,0,0,0,0,0,0,3,0
20200711,654,0,654,0,0,0,0,0,0,0,3,0
20200712,654,0,654,0,0,0,0,0,0,0,3,0
20200713,654,0,654,0,0,0,0,0,0,0,3,0
20200714,654,0,654,0,0,0,0,0,0,0,3,0
20200715,654,0,654,0,0,0,0,0,0,0,3,0
20200716,655,1,654,0,1,1,0,0,0,0,3,0
20200717,655,0,654,0,1,0,0,0,0,0,3,0
20200718,655,0,654,0,1,0,0,0,0,0,3,0
20200719,655,0,654,0,1,0,0,0,0,0,3,0
20200720,655,0,654,0,1,0,0,0,0,0,3,0
20200722,655,0,654,0,1,0,0,0,0,0,3,0
20200724,655,0,654,0,1,0,0,0,0,0,3,0
20200725,655,0,654,0,1,0,0,0,0,0,3,0
20200726,655,0,654,0,1,0,0,0,0,0,3,0
20200727,655,0,654,0,1,0,0,0,0,0,3,0
20200728,655,0,654,0,1,0,0,0,0,0,3,0
20200729,655,0,654,0,1,0,0,0,0,0,3,0
20200730,655,0,654,0,1,0,0,0,0,0,3,0
20200731,655,0,654,0,1,0,0,0,0,0,3,0
20200801,655,0,654,0,1,0,0,0,0,0,3,0
20200802,658,3,654,0,4,3,0,0,0,0,3,0
20200803,658,0,654,0,4,0,0,0,0,0,3,0
20200804,658,0,654,0,4,0,0,0,0,0,3,0
20200806,659,1,654,0,5,1,0,0,0,0,3,0
20200807,659,0,654,0,5,0,0,0,0,0,3,0
20200808,659,0,654,0,5,0,0,0,0,0,3,0
20200809,659,0,654,0,5,0,0,0,0,0,3,0
20200810,659,0,655,1,4,-1,0,0,0,0,3,0
20200812,659,0,656,1,3,-1,0,0,0,0,3,0
20200813,659,0,656,0,3,0,0,0,0,0,3,0
20200814,661,2,655,-1,6,3,0,0,0,0,3,0
20200815,661,0,655,0,6,0,0,0,0,0,3,0
20200816,661,0,655,0,6,0,0,0,0,0,3,0
20200817,664,3,655,0,9,3,0,0,0,0,3,0
20200818,664,0,655,0,9,0,0,0,0,0,3,0
20200820,665,1,656,1,9,0,0,0,0,0,3,0
20200821,665,0,656,0,9,0,0,0,0,0,3,0
20200822,665,0,656,0,9,0,0,0,0,0,3,0
20200823,665,0,656,0,9,0,0,0,0,0,3,0
20200824,665,0,656,0,9,0,0,0,0,0,3,0
20200825,665,0,656,0,9,0,0,0,0,0,3,0
20200826,665,0,657,1,8,-1,0,0,0,0,3,0
20200827,665,0,657,0,8,0,0,0,0,0,3,0
20200828,665,0,657,0,8,0,0,0,0,0,3,0
20200829,665,0,657,0,8,0,0,0,0,0,3,0
20200830,665,0,657,0,8,0,0,0,0,0,3,0
20200831,665,0,658,1,7,-1,0,0,0,0,3,0
20200901,665,0,659,1,6,-1,0,0,0,0,3,0
20200902,665,0,659,0,6,0,0,0,0,0,3,0
20200903,665,0,659,0,6,0,0,0,0,0,3,0
20200904,665,0,661,2,4,-2,0,0,0,0,3,0
20200905,665,0,661,0,4,0,0,0,0,0,3,0
20200906,665,0,661,0,4,0,0,0,0,0,3,0
20200907,665,0,661,0,4,0,0,0,0,0,3,0
20200909,665,0,661,0,4,0,0,0,0,0,3,0
20200910,665,0,663,2,2,-2,0,0,0,0,3,0
20200911,665,0,663,0,2,0,0,0,0,0,3,0
20200913,665,0,663,0,2,0,0,0,0,0,3,0
20200914,665,0,663,0,2,0,0,0,0,0,3,0
20200915,665,0,663,0,2,0,0,0,0,0,3,0
20200919,665,0,664,1,1,-1,0,0,0,0,3,0
20200920,665,0,664,0,1,0,0,0,0,0,3,0
20200921,665,0,664,0,1,0,0,0,0,0,3,0
20200922,665,0,664,0,1,0,0,0,0,0,3,0
20200923,666,1,664,0,2,1,0,0,0,0,3,0
20200924,666,0,664,0,2,0,0,0,0,0,3,0
20200925,666,0,664,0,2,0,0,0,0,0,3,0
20200926,666,0,664,0,2,0,0,0,0,0,3,0
20200927,666,0,664,0,2,0,0,0,0,0,3,0
20200928,666,0,664,0,2,0,0,0,0,0,3,0
20200929,666,0,664,0,2,0,0,0,0,0,3,0
20201001,666,0,664,0,2,0,0,0,0,0,3,0
20201002,666,0,664,0,2,0,0,0,0,0,3,0
20201003,666,0,664,0,2,0,0,0,0,0,3,0
20201004,667,1,664,0,3,1,0,0,0,0,3,0
20201005,667,0,664,0,3,0,0,0,0,0,3,0
20201006,667,0,664,0,3,0,0,0,0,0,3,0
20201007,667,0,664,0,3,0,0,0,0,0,3,0
20201008,667,0,664,0,3,0,0,0,0,0,3,0
20201009,667,0,664,0,3,0,0,0,0,0,3,0
20201010,667,0,664,0,3,0,0,0,0,0,3,0
20201011,667,0,664,0,3,0,0,0,0,0,3,0
20201012,667,0,664,0,3,0,0,0,0,0,3,0
20201013,667,0,664,0,3,0,0,0,0,0,3,0
20201014,667,0,664,0,3,0,0,0,0,0,3,0
20201015,669,2,664,0,5,2,0,0,0,0,3,0
20201016,669,0,665,1,4,-1,0,0,0,0,3,0
20201017,669,0,665,0,4,0,0,0,0,0,3,0
20201018,669,0,665,0,4,0,0,0,0,0,3,0
20201019,670,1,665,0,5,1,0,0,0,0,3,0
20201020,670,0,665,0,5,0,0,0,0,0,3,0
20201021,670,0,665,0,5,0,0,0,0,0,3,0
20201022,670,0,665,0,5,0,0,0,0,0,3,0
20201023,670,0,665,0,5,0,0,0,0,0,3,0
20201024,670,0,665,0,5,0,0,0,0,0,3,0
20201025,670,0,665,0,5,0,0,0,0,0,3,0
20201026,670,0,666,1,4,-1,0,0,0,0,3,0
20201027,670,0,666,0,4,0,0,0,0,0,3,0
20201028,672,2,666,0,6,2,0,0,0,0,3,0
20201030,672,0,666,0,6,0,0,0,0,0,3,0
20201031,672,0,666,0,6,0,0,0,0,0,3,0
20201101,673,1,666,0,7,1,0,0,0,0,3,0
20201102,674,1,666,0,8,1,0,0,0,0,3,0
20201103,674,0,666,0,8,0,0,0,0,0,3,0
20201104,674,0,666,0,8,0,0,0,0,0,3,0
20201105,674,0,666,0,8,0,0,0,0,0,3,0
20201106,674,0,666,0,8,0,0,0,0,0,3,0
20201108,675,1,666,0,9,1,0,0,0,0,3,0
20201109,675,0,666,0,9,0,0,0,0,0,3,0
20201110,676,1,666,0,10,1,0,0,0,0,3,0
20201111,676,0,666,0,10,0,0,0,0,0,3,0
20201112,676,0,666,0,10,0,0,0,0,0,3,0
20201114,676,0,666,0,10,0,0,0,0,0,3,0
20201115,677,1,666,0,11,1,0,0,0,0,3,0
20201117,677,0,668,2,9,-2,0,0,0,0,3,0
20201118,677,0,668,0,9,0,0,0,0,0,3,0
20201119,677,0,668,0,9,0,0,0,0,0,3,0
20201120,677,0,670,2,7,-2,0,0,0,0,3,0
20201121,677,0,670,0,7,0,0,0,0,0,3,0
20201122,677,0,670,0,7,0,0,0,0,0,3,0
20201123,679,2,671,1,8,1,0,0,0,0,3,0
20201124,679,0,671,0,8,0,0,0,0,0,3,0
20201125,680,1,672,1,8,0,0,0,0,0,3,0
20201126,680,0,672,0,8,0,0,0,0,0,3,0
20201127,680,0,672,0,8,0,0,0,0,0,3,0
20201128,680,0,672,0,8,0,0,0,0,0,3,0
20201129,680,0,672,0,8,0,0,0,0,0,3,0
20201130,680,0,672,0,8,0,0,0,0,0,3,0
20201201,680,0,672,0,8,0,0,0,0,0,3,0
20201202,680,0,672,0,8,0,0,0,0,0,3,0
20201203,680,0,672,0,8,0,0,0,0,0,3,0
20201204,680,0,674,2,6,-2,0,0,0,0,3,0
20201206,680,0,674,0,6,0,0,0,0,0,3,0
20201207,680,0,674,0,6,0,0,0,0,0,3,0
20201208,681,1,675,1,6,0,0,0,0,0,3,0
20201209,681,0,675,0,6,0,0,0,0,0,3,0
20201210,681,0,675,0,6,0,0,0,0,0,3,0
20201211,683,2,675,0,8,2,0,0,0,0,3,0
20201212,684,1,675,0,9,1,0,0,0,0,3,0
20201213,684,0,675,0,9,0,0,0,0,0,3,0
20201214,684,0,675,0,9,0,0,0,0,0,3,0
20201215,684,0,675,0,9,0,0,0,0,0,3,0
20201216,684,0,675,0,9,0,0,0,0,0,3,0
20201217,684,0,676,1,8,-1,0,0,0,0,3,0
20201218,684,0,677,1,7,-1,0,0,0,0,3,0
20201219,684,0,678,1,6,-1,0,0,0,0,3,0
20201220,684,0,679,1,5,-1,0,0,0,0,3,0
20201221,684,0,679,0,5,0,0,0,0,0,3,0
20201222,684,0,679,0,5,0,0,0,0,0,3,0
20201223,684,0,679,0,5,0,0,0,0,0,3,0
20201224,684,0,679,0,5,0,0,0,0,0,3,0
20201225,684,0,682,3,2,-3,0,0,0,0,3,0
20201226,684,0,682,0,2,0,0,0,0,0,3,0
20201227,684,0,682,0,2,0,0,0,0,0,3,0
20201228,684,0,682,0,2,0,0,0,0,0,3,0
20201229,684,0,682,0,2,0,0,0,0,0,3,0
20201230,684,0,682,0,2,0,0,0,0,0,3,0
20201231,684,0,682,0,2,0,0,0,0,0,3,0
20210101,684,0,682,0,2,0,0,0,0,0,3,0
20210102,684,0,682,0,2,0,0,0,0,0,3,0
20210103,684,0,683,1,1,-1,0,0,0,0,3,0
20210104,685,1,683,0,2,1,0,0,0,0,3,0
20210105,685,0,684,1,1,-1,0,0,0,0,3,0
20210106,685,0,684,0,1,0,0,0,0,0,3,0
20210107,686,1,684,0,2,1,0,0,0,0,3,0
20210108,687,1,684,0,3,1,0,0,0,0,3,0
20210109,687,0,684,0,3,0,0,0,0,0,3,0
20210110,687,0,684,0,3,0,0,0,0,0,3,0
20210111,687,0,684,0,3,0,0,0,0,0,3,0
20210112,687,0,684,0,3,0,0,0,0,0,3,0
20210113,687,0,684,0,3,0,0,0,0,0,3,0
20210114,688,1,684,0,4,1,0,0,0,0,3,0
20210115,688,0,684,0,4,0,0,0,0,0,3,0
20210116,688,0,684,0,4,0,0,0,0,0,3,0
20210117,688,0,684,0,4,0,0,0,0,0,3,0
20210118,688,0,684,0,4,0,0,0,0,0,3,0
20210119,688,0,684,0,4,0,0,0,0,0,3,0
20210120,688,0,684,0,4,0,0,0,0,0,3,0
20210121,688,0,684,0,4,0,0,0,0,0,3,0
20210122,690,2,685,1,5,1,0,0,0,0,3,0
20210123,691,1,685,0,6,1,0,0,0,0,3,0
20210124,691,0,685,0,6,0,0,0,0,0,3,0
20210125,691,0,685,0,6,0,0,0,0,0,3,0
20210126,692,1,685,0,7,1,0,0,0,0,3,0
20210127,693,1,685,0,8,1,0,0,0,0,3,0
20210128,693,0,685,0,8,0,0,0,0,0,3,0
20210129,693,0,685,0,8,0,0,0,0,0,3,0
20210130,694,1,686,1,8,0,0,0,0,0,3,0
20210131,694,0,686,0,8,0,0,0,0,0,3,0
20210201,697,3,686,0,11,3,0,0,0,0,3,0
20210202,698,1,686,0,12,1,0,0,0,0,3,0
20210203,698,0,686,0,12,0,0,0,0,0,3,0
20210204,699,1,687,1,12,0,0,0,0,0,3,0
20210205,699,0,687,0,12,0,0,0,0,0,3,0
20210206,701,2,687,0,14,2,0,0,0,0,3,0
20210207,701,0,687,0,14,0,0,0,0,0,3,0
20210208,702,1,688,1,14,0,0,0,0,0,3,0
20210209,703,1,688,0,15,1,0,0,0,0,3,0
20210210,703,0,688,0,15,0,0,0,0,0,3,0
20210211,703,0,688,0,15,0,0,0,0,0,3,0
20210212,703,0,688,0,15,0,0,0,0,0,3,0
20210213,703,0,688,0,15,0,0,0,0,0,3,0
20210214,703,0,688,0,15,0,0,0,0,0,3,0
20210215,703,0,688,0,15,0,0,0,0,0,3,0
20210216,703,0,688,0,15,0,0,0,0,0,3,0
20210217,703,0,688,0,15,0,0,0,0,0,3,0
20210218,703,0,689,1,14,-1,0,0,0,0,3,0
20210219,703,0,696,7,7,-7,0,0,0,0,3,0
20210220,703,0,696,0,7,0,0,0,0,0,3,0
20210221,703,0,698,2,5,-2,0,0,0,0,3,0
20210222,703,0,698,0,5,0,0,0,0,0,3,0
20210223,704,1,698,0,6,1,0,0,0,0,3,0
20210224,704,0,698,0,6,0,0,0,0,0,3,0
20210225,704,0,698,0,6,0,0,0,0,0,3,0
20210226,704,0,698,0,6,0,0,0,0,0,3,0
20210227,704,0,698,0,6,0,0,0,0,0,3,0
20210228,704,0,698,0,6,0,0,0,0,0,3,0
20210301,704,0,699,1,5,-1,0,0,0,0,3,0
20210302,704,0,700,1,4,-1,0,0,0,0,3,0
20210303,704,0,700,0,4,0,0,0,0,0,3,0
20210304,704,0,701,1,3,-1,0,0,0,0,3,0
20210305,704,0,702,1,2,-1,0,0,0,0,3,0
20210306,704,0,702,0,2,0,0,0,0,0,3,0
20210307,704,0,702,0,2,0,0,0,0,0,3,0
20210308,705,1,703,1,2,0,0,0,0,0,3,0
20210309,705,0,703,0,2,0,0,0,0,0,3,0
20210310,705,0,703,0,2,0,0,0,0,0,3,0
20210311,705,0,704,1,1,-1,0,0,0,0,3,0
20210312,705,0,704,0,1,0,0,0,0,0,3,0
20210313,706,1,704,0,2,1,0,0,0,0,3,0
20210314,706,0,704,0,2,0,0,0,0,0,3,0
20210315,707,1,704,0,3,1,0,0,0,0,3,0
20210316,707,0,704,0,3,0,0,0,0,0,3,0
20210317,707,0,704,0,3,0,0,0,0,0,3,0
20210318,707,0,704,0,3,0,0,0,0,0,3,0
20210319,708,1,704,0,4,1,0,0,0,0,3,0
20210320,708,0,704,0,4,0,0,0,0,0,3,0
20210321,708,0,704,0,4,0,0,0,0,0,3,0
20210322,708,0,704,0,4,0,0,0,0,0,3,0
20210323,708,0,704,0,4,0,0,0,0,0,3,0
20210324,708,0,704,0,4,0,0,0,0,0,3,0
20210325,708,0,704,0,4,0,0,0,0,0,3,0
20210326,708,0,704,0,4,0,0,0,0,0,3,0
20210327,708,0,704,0,4,0,0,0,0,0,3,0
20210328,708,0,704,0,4,0,0,0,0,0,3,0
20210329,708,0,704,0,4,0,0,0,0,0,3,0
20210330,708,0,704,0,4,0,0,0,0,0,3,0
20210331,710,2,704,0,6,2,0,0,0,0,3,0
20210401,710,0,704,0,6,0,0,0,0,0,3,0
20210402,710,0,704,0,6,0,0,0,0,0,3,0
20210403,711,1,704,0,7,1,0,0,0,0,3,0
20210404,713,2,704,0,9,2,0,0,0,0,3,0
20210405,714,1,704,0,10,1,0,0,0,0,3,0
20210406,715,1,706,2,9,-1,0,0,0,0,3,0
20210407,716,1,707,1,9,0,0,0,0,0,3,0
20210408,716,0,707,0,9,0,0,0,0,0,3,0
20210409,716,0,707,0,9,0,0,0,0,0,3,0
20210410,716,0,708,1,8,-1,0,0,0,0,3,0
20210411,716,0,708,0,8,0,0,0,0,0,3,0
20210412,716,0,708,0,8,0,0,0,0,0,3,0
20210413,716,0,708,0,8,0,0,0,0,0,3,0
20210414,716,0,708,0,8,0,0,0,0,0,3,0
20210415,716,0,708,0,8,0,0,0,0,0,3,0
20210416,716,0,708,0,8,0,0,0,0,0,3,0
20210417,716,0,708,0,8,0,0,0,0,0,3,0
20210418,716,0,708,0,8,0,0,0,0,0,3,0
20210419,716,0,708,0,8,0,0,0,0,0,3,0
20210420,716,0,708,0,8,0,0,0,0,0,3,0
20210421,716,0,708,0,8,0,0,0,0,0,3,0
20210422,716,0,708,0,8,0,0,0,0,0,3,0
20210423,716,0,708,0,8,0,0,0,0,0,3,0
20210424,717,1,708,0,9,1,0,0,0,0,3,0
20210425,718,1,709,1,9,0,0,0,0,0,3,0
20210426,718,0,709,0,9,0,0,0,0,0,3,0
20210427,718,0,709,0,9,0,0,0,0,0,3,0
20210428,718,0,709,0,9,0,0,0,0,0,3,0
20210429,719,1,709,0,10,1,0,0,0,0,3,0
20210430,719,0,710,1,9,-1,0,0,0,0,3,0
20210501,719,0,711,1,8,-1,0,0,0,0,3,0
20210502,719,0,711,0,8,0,0,0,0,0,3,0
20210503,720,1,711,0,9,1,0,0,0,0,3,0
20210504,720,0,711,0,9,0,0,0,0,0,3,0
20210505,720,0,711,0,9,0,0,0,0,0,3,0
20210506,720,0,711,0,9,0,0,0,0,0,3,0
20210507,720,0,712,1,8,-1,0,0,0,0,3,0
20210508,720,0,712,0,8,0,0,0,0,0,3,0
20210509,720,0,712,0,8,0,0,0,0,0,3,0
20210510,720,0,712,0,8,0,0,0,0,0,3,0
20210511,721,1,713,1,8,0,0,0,0,0,3,0
20210512,721,0,713,0,8,0,0,0,0,0,3,0
20210513,721,0,713,0,8,0,0,0,0,0,3,0
20210514,721,0,713,0,8,0,0,0,0,0,3,0
20210515,721,0,713,0,8,0,0,0,0,0,3,0
20210516,721,0,713,0,8,0,0,0,0,0,3,0
20210517,721,0,713,0,8,0,0,0,0,0,3,0
20210518,722,1,713,0,9,1,0,0,0,0,3,0
20210519,722,0,713,0,9,0,0,0,0,0,3,0
20210520,722,0,713,0,9,0,0,0,0,0,3,0
20210521,722,0,713,0,9,0,0,0,0,0,3,0
20210522,722,0,713,0,9,0,0,0,0,0,3,0
20210523,723,1,713,0,10,1,0,0,0,0,3,0
20210524,724,1,714,1,10,0,0,0,0,0,3,0
20210525,725,1,715,1,10,0,0,0,0,0,3,0
20210526,725,0,715,0,10,0,0,0,0,0,3,0
20210527,726,1,715,0,11,1,0,0,0,0,3,0
20210528,726,0,715,0,11,0,0,0,0,0,3,0
20210529,726,0,716,1,10,-1,0,0,0,0,3,0
20210530,726,0,716,0,10,0,0,0,0,0,3,0
20210531,727,1,717,1,10,0,0,0,0,0,3,0
20210601,727,0,718,1,9,-1,0,0,0,0,3,0
20210602,727,0,718,0,9,0,0,0,0,0,3,0
20210603,727,0,719,1,8,-1,0,0,0,0,3,0
20210604,727,0,719,0,8,0,0,0,0,0,3,0
20210605,728,1,719,0,9,1,0,0,0,0,3,0
20210606,728,0,719,0,9,0,0,0,0,0,3,0
20210607,729,1,719,0,10,1,0,0,0,0,3,0
20210608,729,0,719,0,10,0,0,0,0,0,3,0
20210609,729,0,720,1,9,-1,0,0,0,0,3,0
20210610,730,1,720,0,10,1,0,0,0,0,3,0
20210611,734,4,720,0,14,4,0,0,0,0,3,0
20210612,735,1,721,1,14,0,0,0,0,0,3,0
20210613,736,1,721,0,15,1,0,0,0,0,3,0
20210614,736,0,721,0,15,0,0,0,0,0,3,0
20210615,738,2,721,0,17,2,0,0,0,0,3,0
20210616,739,1,721,0,18,1,0,0,0,0,3,0
20210617,739,0,721,0,18,0,0,0,0,0,3,0
20210618,739,0,723,2,16,-2,0,0,0,0,3,0
20210619,739,0,725,2,14,-2,0,0,0,0,3,0
20210620,740,1,725,0,15,1,0,0,0,0,3,0
20210621,740,0,726,1,14,-1,0,0,0,0,3,0
20210622,742,2,728,2,14,0,0,0,0,0,3,0
20210623,742,0,728,0,14,0,0,0,0,0,3,0
20210624,742,0,729,1,13,-1,0,0,0,0,3,0
20210625,742,0,729,0,13,0,0,0,0,0,3,0
20210626,742,0,729,0,13,0,0,0,0,0,3,0
20210627,742,0,729,0,13,0,0,0,0,0,3,0
20210628,742,0,729,0,13,0,0,0,0,0,3,0
20210629,742,0,731,2,11,-2,0,0,0,0,3,0
20210630,742,0,732,1,10,-1,0,0,0,0,3,0
20210701,743,1,732,0,11,1,0,0,0,0,3,0
20210702,743,0,733,1,10,-1,0,0,0,0,3,0
20210703,743,0,733,0,10,0,0,0,0,0,3,0
20210704,743,0,733,0,10,0,0,0,0,0,3,0
20210705,743,0,733,0,10,0,0,0,0,0,3,0
20210706,744,1,734,1,10,0,0,0,0,0,3,0
20210707,744,0,734,0,10,0,0,0,0,0,3,0
20210708,744,0,734,0,10,0,0,0,0,0,3,0
20210709,744,0,734,0,10,0,0,0,0,0,3,0
20210710,744,0,737,3,7,-3,0,0,0,0,3,0
20210711,745,1,738,1,7,0,0,0,0,0,3,0
20210712,747,2,738,0,9,2,0,0,0,0,3,0
20210713,748,1,738,0,10,1,0,0,0,0,3,0
20210714,748,0,738,0,10,0,0,0,0,0,3,0
20210715,750,2,738,0,12,2,0,0,0,0,3,0
20210716,750,0,738,0,12,0,0,0,0,0,3,0
20210717,751,1,738,0,13,1,0,0,0,0,3,0
20210718,751,0,739,1,12,-1,0,0,0,0,3,0
20210719,751,0,739,0,12,0,0,0,0,0,3,0
20210720,753,2,739,0,14,2,0,0,0,0,3,0
20210721,764,11,741,2,23,9,0,0,0,4,3,0
20210722,776,12,743,2,33,10,0,0,0,10,3,0
20210723,788,12,743,0,45,12,0,0,1,20,3,0
20210724,790,2,743,0,47,2,0,0,1,20,3,0
20210725,829,39,744,1,85,38,0,0,2,23,3,0
20210726,863,34,744,0,119,34,0,0,4,26,3,0
20210727,911,48,744,0,167,48,0,0,4,37,3,0
20210728,931,20,744,0,187,20,0,0,4,42,3,0
20210729,949,18,744,0,205,18,0,0,1,28,3,0
20210730,968,19,744,0,224,19,0,0,1,31,3,0
20210731,998,30,744,0,254,30,0,0,1,41,3,0
20210801,1041,43,744,0,297,43,0,0,2,48,3,0
20210802,1041,0,744,0,297,0,0,0,2,71,3,0
20210803,1088,47,744,0,344,47,0,0,2,81,3,0
20210804,1166,78,752,8,414,70,0,0,2,91,3,0
20210805,1227,61,759,7,468,54,0,0,2,107,3,0
20210806,1281,54,764,5,517,49,0,0,2,110,3,0
20210807,1319,38,766,2,553,36,0,0,2,113,3,0
20210808,1357,38,770,4,587,34,0,0,3,116,3,0
20210809,1407,50,773,3,634,47,0,0,3,115,3,0
20210810,1461,54,776,3,685,51,0,0,3,121,3,0
20210811,1499,38,778,2,721,36,0,0,4,110,3,0
20210812,1525,26,788,10,737,16,0,0,10,47,3,0
20210813,1525,0,788,0,737,0,0,0,10,44,3,0
20210814,1561,36,805,17,756,19,0,0,11,37,3,0
20210815,1567,6,814,9,753,-3,0,0,10,36,3,0
20210816,1570,3,831,17,739,-14,0,0,10,28,3,0
20210817,1570,0,831,0,739,0,0,0,10,28,3,0
20210818,1579,9,882,51,697,-42,0,0,10,28,3,0
20210819,1582,3,911,29,671,-26,0,0,10,26,3,0
20210820,1583,1,934,23,649,-22,0,0,10,26,3,0
20210821,1584,1,965,31,619,-30,0,0,5,22,3,0
20210822,1584,0,1004,39,580,-39,0,0,1,23,3,0
20210823,1584,0,1004,0,580,0,0,0,1,23,3,0
20210824,1586,2,1071,67,515,-65,0,0,1,21,3,0
20210825,1586,0,1124,53,462,-53,0,0,0,16,3,0
20210826,1587,1,1162,38,425,-37,0,0,0,12,3,0
20210827,1587,0,1212,50,375,-50,0,0,0,7,3,0
