日期,确诊总数,今日确诊数,治愈总数,治愈新增,现存感染数,现存增加数,死亡人数,新增死亡,高风险地区数,中风险地区数,疑似总数,新增疑似
20200122,1,1,0,0,1,1,0,0,0,0,0,0
20200123,1,0,0,0,1,0,0,0,0,0,0,0
20200124,6,5,0,0,6,5,0,0,0,0,0,0
20200125,9,3,0,0,9,3,0,0,0,0,0,0
20200126,13,4,0,0,13,4,0,0,0,0,0,0
20200127,20,7,0,0,20,7,0,0,0,0,0,0
20200128,27,7,0,0,27,7,0,0,0,0,0,0
20200129,35,8,1,1,34,7,0,0,0,0,0,0
20200130,39,4,1,0,38,4,0,0,0,0,0,0
20200131,47,8,1,0,46,8,0,0,0,0,0,0
20200201,56,9,1,0,55,9,0,0,0,0,0,0
20200202,66,10,2,1,64,9,0,0,0,0,0,0
20200203,74,8,2,0,72,8,0,0,0,0,0,0
20200204,81,7,4,2,77,5,0,0,0,0,0,0
20200205,90,9,6,2,84,7,0,0,0,0,0,0
20200206,96,6,12,6,84,0,0,0,0,0,0,0
20200207,104,8,15,3,89,5,0,0,0,0,0,0
20200208,115,11,21,6,94,5,0,0,0,0,0,0
20200209,119,4,25,4,94,0,0,0,0,0,0,0
20200210,122,3,26,1,96,2,0,0,0,0,0,0
20200211,124,2,30,4,94,-2,0,0,0,0,0,0
20200212,126,2,33,3,93,-1,0,0,0,0,0,0
20200213,126,0,36,3,90,-3,0,0,0,0,0,0
20200214,127,1,38,2,89,-1,0,0,0,0,0,0
20200215,128,1,46,8,82,-7,0,0,0,0,0,0
20200216,129,1,50,4,79,-3,0,0,0,0,0,0
20200217,130,1,53,3,77,-2,0,0,0,0,0,0
20200218,131,1,61,8,70,-7,0,0,0,0,0,0
20200219,131,0,68,7,63,-7,0,0,0,0,0,0
20200220,132,1,76,8,56,-7,0,0,0,0,0,0
20200221,132,0,78,2,54,-2,0,0,0,0,0,0
20200222,132,0,81,3,51,-3,0,0,0,0,0,0
20200223,132,0,88,7,44,-7,0,0,0,0,0,0
20200224,133,1,94,6,39,-5,0,0,0,0,0,0
20200225,133,0,98,4,35,-4,0,0,0,0,0,0
20200226,133,0,104,6,29,-6,0,0,0,0,0,0
20200227,133,0,107,3,26,-3,0,0,0,0,0,0
20200228,133,0,112,5,21,-5,0,0,0,0,0,0
20200229,133,0,114,2,19,-2,0,0,0,0,0,0
20200301,133,0,116,2,17,-2,0,0,0,0,0,0
20200302,133,0,119,3,14,-3,0,0,0,0,0,0
20200303,133,0,124,5,9,-5,0,0,0,0,0,0
20200304,133,0,124,0,9,0,0,0,0,0,0,0
20200305,133,0,126,2,7,-2,0,0,0,0,0,0
20200306,133,0,126,0,7,0,0,0,0,0,0,0
20200307,133,0,126,0,7,0,0,0,0,0,0,0
20200308,133,0,126,0,7,0,0,0,0,0,0,0
20200309,133,0,127,1,6,-1,0,0,0,0,0,0
20200310,133,0,131,4,2,-4,0,0,0,0,0,0
20200311,133,0,131,0,2,0,0,0,0,0,0,0
20200312,133,0,132,1,1,-1,0,0,0,0,0,0
20200313,133,0,133,1,0,-1,0,0,0,0,0,0
20200314,133,0,133,0,0,0,0,0,0,0,0,0
20200315,133,0,133,0,0,0,0,0,0,0,0,0
20200316,133,0,133,0,0,0,0,0,0,0,0,0
20200317,133,0,133,0,0,0,0,0,0,0,0,0
20200318,133,0,133,0,0,0,0,0,0,0,0,0
20200319,133,0,133,0,0,0,0,0,0,0,0,0
20200320,133,0,133,0,0,0,0,0,0,0,0,0
20200321,133,0,133,0,0,0,0,0,0,0,0,0
20200322,133,0,133,0,0,0,0,0,0,0,0,0
20200323,134,1,133,0,1,1,0,0,0,0,0,0
20200324,134,0,133,0,1,0,0,0,0,0,0,0
20200325,135,1,133,0,2,1,0,0,0,0,0,0
20200326,135,0,133,0,2,0,0,0,0,0,0,0
20200327,135,0,133,0,2,0,0,0,0,0,0,0
20200328,136,1,133,0,3,1,0,0,0,0,1,1
20200329,136,0,133,0,3,0,0,0,0,0,1,0
20200330,136,0,133,0,3,0,0,0,0,0,1,0
20200331,137,1,133,0,4,1,0,0,0,0,4,3
20200401,137,0,133,0,4,0,0,0,0,0,4,0
20200402,137,0,133,0,4,0,0,0,0,0,0,-4
20200403,137,0,133,0,4,0,0,0,0,0,0,0
20200404,138,1,133,0,5,1,0,0,0,0,5,5
20200405,138,0,133,0,5,0,0,0,0,0,5,0
20200406,138,0,133,0,5,0,0,0,0,0,5,0
20200407,163,25,134,1,29,24,0,0,0,0,0,-5
20200408,166,3,134,0,32,3,0,0,0,0,0,0
20200409,168,2,134,0,34,2,0,0,0,0,5,5
20200410,172,4,135,1,37,3,0,0,0,0,5,0
20200411,172,0,135,0,37,0,0,0,0,0,5,0
20200412,173,1,135,0,38,1,0,0,0,0,5,0
20200413,173,0,135,0,38,0,0,0,0,0,5,0
20200414,186,13,135,0,51,13,0,0,0,0,18,13
20200415,194,8,135,0,59,8,0,0,0,0,18,0
20200416,197,3,135,0,62,3,0,0,0,0,18,0
20200417,197,0,135,0,62,0,0,0,0,0,18,0
20200418,197,0,135,0,62,0,0,0,0,0,18,0
20200419,197,0,135,0,62,0,0,0,0,0,18,0
20200420,197,0,140,5,57,-5,0,0,0,0,18,0
20200421,197,0,140,0,57,0,0,0,0,0,18,0
20200422,197,0,142,2,55,-2,0,0,0,0,18,0
20200423,197,0,142,0,55,0,0,0,0,0,18,0
20200424,197,0,149,7,48,-7,0,0,0,0,18,0
20200425,197,0,154,5,43,-5,0,0,0,0,18,0
20200426,197,0,157,3,40,-3,0,0,0,0,18,0
20200427,197,0,160,3,37,-3,0,0,0,0,18,0
20200428,197,0,160,0,37,0,0,0,0,0,18,0
20200429,197,0,164,4,33,-4,0,0,0,0,18,0
20200430,197,0,172,8,25,-8,0,0,0,0,18,0
20200501,197,0,176,4,21,-4,0,0,0,0,18,0
20200502,198,1,176,0,22,1,0,0,0,0,18,0
20200503,198,0,180,4,18,-4,0,0,0,0,64,46
20200504,198,0,190,10,8,-10,0,0,0,0,64,0
20200505,198,0,193,3,5,-3,0,0,0,0,64,0
20200506,198,0,194,1,4,-1,0,0,0,0,64,0
20200507,198,0,195,1,3,-1,0,0,0,0,64,0
20200508,198,0,196,1,2,-1,0,0,0,0,64,0
20200509,198,0,197,1,1,-1,0,0,0,0,64,0
20200510,198,0,197,0,1,0,0,0,0,0,64,0
20200511,198,0,197,0,1,0,0,0,0,0,64,0
20200512,198,0,198,1,0,-1,0,0,0,0,64,0
20200513,198,0,198,0,0,0,0,0,0,0,64,0
20200514,198,0,198,0,0,0,0,0,0,0,64,0
20200515,198,0,198,0,0,0,0,0,0,0,64,0
20200516,198,0,198,0,0,0,0,0,0,0,64,0
20200517,198,0,198,0,0,0,0,0,0,0,64,0
20200518,198,0,198,0,0,0,0,0,0,0,64,0
20200519,198,0,198,0,0,0,0,0,0,0,64,0
20200520,198,0,198,0,0,0,0,0,0,0,64,0
20200521,198,0,198,0,0,0,0,0,0,0,64,0
20200522,198,0,198,0,0,0,0,0,0,0,64,0
20200523,198,0,198,0,0,0,0,0,0,0,64,0
20200524,198,0,198,0,0,0,0,0,0,0,64,0
20200525,198,0,198,0,0,0,0,0,0,0,64,0
20200526,198,0,198,0,0,0,0,0,0,0,64,0
20200527,198,0,198,0,0,0,0,0,0,0,64,0
20200528,198,0,198,0,0,0,0,0,0,0,64,0
20200529,198,0,198,0,0,0,0,0,0,0,64,0
20200530,198,0,198,0,0,0,0,0,0,0,64,0
20200531,198,0,198,0,0,0,0,0,0,0,64,0
20200601,198,0,198,0,0,0,0,0,0,0,64,0
20200602,198,0,198,0,0,0,0,0,0,0,64,0
20200603,198,0,198,0,0,0,0,0,0,0,64,0
20200604,198,0,198,0,0,0,0,0,0,0,64,0
20200605,198,0,198,0,0,0,0,0,0,0,64,0
20200606,198,0,198,0,0,0,0,0,0,0,64,0
20200607,198,0,198,0,0,0,0,0,0,0,64,0
20200608,198,0,198,0,0,0,0,0,0,0,64,0
20200609,198,0,198,0,0,0,0,0,0,0,64,0
20200610,198,0,198,0,0,0,0,0,0,0,64,0
20200611,198,0,198,0,0,0,0,0,0,0,64,0
20200612,198,0,198,0,0,0,0,0,0,0,64,0
20200613,198,0,198,0,0,0,0,0,0,0,64,0
20200614,198,0,198,0,0,0,0,0,0,0,64,0
20200615,198,0,198,0,0,0,0,0,0,0,64,0
20200616,198,0,198,0,0,0,0,0,0,0,64,0
20200617,198,0,198,0,0,0,0,0,0,0,64,0
20200618,198,0,198,0,0,0,0,0,0,0,64,0
20200619,198,0,198,0,0,0,0,0,0,0,64,0
20200620,198,0,198,0,0,0,0,0,0,0,64,0
20200621,198,0,198,0,0,0,0,0,0,0,64,0
20200622,198,0,198,0,0,0,0,0,0,0,64,0
20200623,198,0,198,0,0,0,0,0,0,0,64,0
20200624,198,0,198,0,0,0,0,0,0,0,64,0
20200625,198,0,198,0,0,0,0,0,0,0,64,0
20200626,198,0,198,0,0,0,0,0,0,0,64,0
20200627,198,0,198,0,0,0,0,0,0,0,64,0
20200628,198,0,198,0,0,0,0,0,0,0,64,0
20200629,198,0,198,0,0,0,0,0,0,0,64,0
20200630,198,0,198,0,0,0,0,0,0,0,64,0
20200701,198,0,198,0,0,0,0,0,0,0,64,0
20200702,198,0,198,0,0,0,0,0,0,0,64,0
20200703,198,0,198,0,0,0,0,0,0,0,64,0
20200704,198,0,198,0,0,0,0,0,0,0,64,0
20200705,198,0,198,0,0,0,0,0,0,0,64,0
20200706,198,0,198,0,0,0,0,0,0,0,64,0
20200707,199,1,198,0,1,1,0,0,0,0,64,0
20200708,199,0,198,0,1,0,0,0,0,0,64,0
20200709,200,1,198,0,2,1,0,0,0,0,64,0
20200710,200,0,198,0,2,0,0,0,0,0,64,0
20200711,200,0,198,0,2,0,0,0,0,0,64,0
20200712,200,0,198,0,2,0,0,0,0,0,64,0
20200713,200,0,198,0,2,0,0,0,0,0,64,0
20200714,201,1,198,0,3,1,0,0,0,0,64,0
20200715,201,0,198,0,3,0,0,0,0,0,64,0
20200716,201,0,200,2,1,-2,0,0,0,0,64,0
20200717,201,0,200,0,1,0,0,0,0,0,64,0
20200718,201,0,200,0,1,0,0,0,0,0,64,0
20200719,201,0,200,0,1,0,0,0,0,0,64,0
20200720,201,0,200,0,1,0,0,0,0,0,64,0
20200722,201,0,200,0,1,0,0,0,0,0,64,0
20200724,201,0,201,1,0,-1,0,0,0,0,64,0
20200725,201,0,201,0,0,0,0,0,0,0,64,0
20200726,201,0,201,0,0,0,0,0,0,0,64,0
20200727,201,0,201,0,0,0,0,0,0,0,64,0
20200728,201,0,201,0,0,0,0,0,0,0,64,0
20200729,201,0,201,0,0,0,0,0,0,0,64,0
20200730,201,0,201,0,0,0,0,0,0,0,64,0
20200731,201,0,201,0,0,0,0,0,0,0,64,0
20200801,201,0,201,0,0,0,0,0,0,0,64,0
20200802,201,0,201,0,0,0,0,0,0,0,64,0
20200803,201,0,201,0,0,0,0,0,0,0,64,0
20200804,201,0,201,0,0,0,0,0,0,0,64,0
20200806,201,0,201,0,0,0,0,0,0,0,64,0
20200807,201,0,201,0,0,0,0,0,0,0,64,0
20200808,201,0,201,0,0,0,0,0,0,0,64,0
20200809,201,0,201,0,0,0,0,0,0,0,64,0
20200810,201,0,201,0,0,0,0,0,0,0,64,0
20200812,201,0,201,0,0,0,0,0,0,0,64,0
20200813,201,0,201,0,0,0,0,0,0,0,64,0
20200814,201,0,201,0,0,0,0,0,0,0,64,0
20200815,201,0,201,0,0,0,0,0,0,0,64,0
20200816,201,0,201,0,0,0,0,0,0,0,64,0
20200817,201,0,201,0,0,0,0,0,0,0,64,0
20200818,201,0,201,0,0,0,0,0,0,0,64,0
20200820,201,0,201,0,0,0,0,0,0,0,64,0
20200821,201,0,201,0,0,0,0,0,0,0,64,0
20200822,201,0,201,0,0,0,0,0,0,0,64,0
20200823,202,1,201,0,1,1,0,0,0,0,64,0
20200824,202,0,201,0,1,0,0,0,0,0,64,0
20200825,202,0,201,0,1,0,0,0,0,0,64,0
20200826,202,0,201,0,1,0,0,0,0,0,64,0
20200827,202,0,201,0,1,0,0,0,0,0,64,0
20200828,202,0,201,0,1,0,0,0,0,0,64,0
20200829,202,0,201,0,1,0,0,0,0,0,64,0
20200830,203,1,201,0,2,1,0,0,0,0,64,0
20200831,203,0,201,0,2,0,0,0,0,0,64,0
20200901,203,0,201,0,2,0,0,0,0,0,64,0
20200902,203,0,201,0,2,0,0,0,0,0,64,0
20200903,203,0,201,0,2,0,0,0,0,0,64,0
20200904,203,0,201,0,2,0,0,0,0,0,64,0
20200905,203,0,201,0,2,0,0,0,0,0,64,0
20200906,203,0,201,0,2,0,0,0,0,0,64,0
20200907,203,0,201,0,2,0,0,0,0,0,64,0
20200909,203,0,201,0,2,0,0,0,0,0,64,0
20200910,203,0,201,0,2,0,0,0,0,0,64,0
20200911,203,0,202,1,1,-1,0,0,0,0,64,0
20200913,203,0,202,0,1,0,0,0,0,0,64,0
20200914,203,0,202,0,1,0,0,0,0,0,64,0
20200915,203,0,202,0,1,0,0,0,0,0,64,0
20200919,203,0,203,1,0,-1,0,0,0,0,64,0
20200920,203,0,203,0,0,0,0,0,0,0,64,0
20200921,203,0,203,0,0,0,0,0,0,0,64,0
20200922,203,0,203,0,0,0,0,0,0,0,64,0
20200923,203,0,203,0,0,0,0,0,0,0,64,0
20200924,203,0,203,0,0,0,0,0,0,0,64,0
20200925,203,0,203,0,0,0,0,0,0,0,64,0
20200926,203,0,203,0,0,0,0,0,0,0,64,0
20200927,204,1,203,0,1,1,0,0,0,0,64,0
20200928,204,0,203,0,1,0,0,0,0,0,64,0
20200929,204,0,203,0,1,0,0,0,0,0,64,0
20201001,204,0,203,0,1,0,0,0,0,0,64,0
20201002,204,0,203,0,1,0,0,0,0,0,64,0
20201003,204,0,203,0,1,0,0,0,0,0,64,0
20201004,205,1,203,0,2,1,0,0,0,0,64,0
20201005,205,0,203,0,2,0,0,0,0,0,64,0
20201006,206,1,203,0,3,1,0,0,0,0,64,0
20201007,206,0,203,0,3,0,0,0,0,0,64,0
20201008,206,0,203,0,3,0,0,0,0,0,64,0
20201009,206,0,203,0,3,0,0,0,0,0,64,0
20201010,206,0,203,0,3,0,0,0,0,0,64,0
20201011,208,2,203,0,5,2,0,0,0,0,64,0
20201012,208,0,203,0,5,0,0,0,0,0,64,0
20201013,208,0,203,0,5,0,0,0,0,0,64,0
20201014,208,0,204,1,4,-1,0,0,0,0,64,0
20201015,208,0,204,0,4,0,0,0,0,0,64,0
20201016,208,0,204,0,4,0,0,0,0,0,64,0
20201017,208,0,204,0,4,0,0,0,0,0,64,0
20201018,209,1,204,0,5,1,0,0,0,0,64,0
20201019,209,0,204,0,5,0,0,0,0,0,64,0
20201020,209,0,204,0,5,0,0,0,0,0,64,0
20201021,209,0,204,0,5,0,0,0,0,0,64,0
20201022,209,0,204,0,5,0,0,0,0,0,64,0
20201023,209,0,205,1,4,-1,0,0,0,0,64,0
20201024,211,2,205,0,6,2,0,0,0,0,64,0
20201025,212,1,205,0,7,1,0,0,0,0,64,0
20201026,212,0,205,0,7,0,0,0,0,0,64,0
20201027,212,0,205,0,7,0,0,0,0,0,64,0
20201028,212,0,206,1,6,-1,0,0,0,0,64,0
20201030,212,0,206,0,6,0,0,0,0,0,64,0
20201031,212,0,208,2,4,-2,0,0,0,0,64,0
20201101,215,3,208,0,7,3,0,0,0,0,64,0
20201102,215,0,208,0,7,0,0,0,0,0,64,0
20201103,215,0,210,2,5,-2,0,0,0,0,64,0
20201104,215,0,211,1,4,-1,0,0,0,0,64,0
20201105,216,1,211,0,5,1,0,0,0,0,64,0
20201106,216,0,213,2,3,-2,0,0,0,0,64,0
20201108,218,2,213,0,5,2,0,0,0,0,64,0
20201109,218,0,213,0,5,0,0,0,0,0,64,0
20201110,218,0,213,0,5,0,0,0,0,0,64,0
20201111,218,0,213,0,5,0,0,0,0,0,64,0
20201112,218,0,213,0,5,0,0,0,0,0,64,0
20201114,218,0,213,0,5,0,0,0,0,0,64,0
20201115,219,1,213,0,6,1,0,0,0,0,64,0
20201117,220,1,213,0,7,1,0,0,0,0,64,0
20201118,220,0,213,0,7,0,0,0,0,0,64,0
20201119,220,0,213,0,7,0,0,0,0,0,64,0
20201120,220,0,213,0,7,0,0,0,0,0,64,0
20201121,220,0,214,1,6,-1,0,0,0,0,64,0
20201122,220,0,215,1,5,-1,0,0,0,0,64,0
20201123,220,0,215,0,5,0,0,0,0,0,64,0
20201124,220,0,215,0,5,0,0,0,0,0,64,0
20201125,220,0,216,1,4,-1,0,0,0,0,64,0
20201126,220,0,217,1,3,-1,0,0,0,0,64,0
20201127,220,0,217,0,3,0,0,0,0,0,64,0
20201128,220,0,217,0,3,0,0,0,0,0,64,0
20201129,221,1,217,0,4,1,0,0,0,0,64,0
20201130,221,0,217,0,4,0,0,0,0,0,64,0
20201201,221,0,218,1,3,-1,0,0,0,0,64,0
20201202,221,0,218,0,3,0,0,0,0,0,64,0
20201203,221,0,218,0,3,0,0,0,0,0,64,0
20201204,222,1,218,0,4,1,0,0,0,0,64,0
20201206,222,0,218,0,4,0,0,0,0,0,64,0
20201207,222,0,218,0,4,0,0,0,0,0,64,0
20201208,222,0,218,0,4,0,0,0,0,0,64,0
20201209,222,0,218,0,4,0,0,0,0,0,64,0
20201210,222,0,218,0,4,0,0,0,0,0,64,0
20201211,222,0,218,0,4,0,0,0,0,0,64,0
20201212,222,0,218,0,4,0,0,0,0,0,64,0
20201213,222,0,218,0,4,0,0,0,0,0,64,0
20201214,222,0,220,2,2,-2,0,0,0,0,64,0
20201215,222,0,220,0,2,0,0,0,0,0,64,0
20201216,222,0,220,0,2,0,0,0,0,0,64,0
20201217,223,1,220,0,3,1,0,0,0,0,64,0
20201218,223,0,220,0,3,0,0,0,0,0,64,0
20201219,223,0,220,0,3,0,0,0,0,0,64,0
20201220,224,1,220,0,4,1,0,0,0,0,64,0
20201221,224,0,220,0,4,0,0,0,0,0,64,0
20201222,224,0,221,1,3,-1,0,0,0,0,64,0
20201223,224,0,221,0,3,0,0,0,0,0,64,0
20201224,224,0,221,0,3,0,0,0,0,0,64,0
20201225,224,0,221,0,3,0,0,0,0,0,64,0
20201226,224,0,221,0,3,0,0,0,0,0,64,0
20201227,224,0,221,0,3,0,0,0,0,0,64,0
20201228,224,0,221,0,3,0,0,0,0,0,64,0
20201229,224,0,221,0,3,0,0,0,0,0,64,0
20201230,224,0,221,0,3,0,0,0,0,0,64,0
20201231,224,0,221,0,3,0,0,0,0,0,64,0
20210101,224,0,221,0,3,0,0,0,0,0,64,0
20210102,224,0,221,0,3,0,0,0,0,0,64,0
20210103,225,1,221,0,4,1,0,0,0,0,64,0
20210104,225,0,222,1,3,-1,0,0,0,0,64,0
20210105,225,0,222,0,3,0,0,0,0,0,64,0
20210106,225,0,222,0,3,0,0,0,0,0,64,0
20210107,225,0,222,0,3,0,0,0,0,0,64,0
20210108,225,0,223,1,2,-1,0,0,0,0,64,0
20210109,226,1,223,0,3,1,0,0,0,0,64,0
20210110,226,0,224,1,2,-1,0,0,0,0,64,0
20210111,226,0,224,0,2,0,0,0,0,0,64,0
20210112,227,1,224,0,3,1,0,0,0,0,64,0
20210113,227,0,224,0,3,0,0,0,0,0,64,0
20210114,227,0,224,0,3,0,0,0,0,0,64,0
20210115,227,0,224,0,3,0,0,0,0,0,64,0
20210116,227,0,224,0,3,0,0,0,0,0,64,0
20210117,227,0,224,0,3,0,0,0,0,0,64,0
20210118,228,1,224,0,4,1,0,0,0,0,64,0
20210119,228,0,224,0,4,0,0,0,0,0,64,0
20210120,230,2,224,0,6,2,0,0,0,0,64,0
20210121,231,1,224,0,7,1,0,0,0,0,64,0
20210122,235,4,224,0,11,4,0,0,0,0,64,0
20210123,237,2,224,0,13,2,0,0,0,0,64,0
20210124,237,0,225,1,12,-1,0,0,0,0,64,0
20210125,237,0,225,0,12,0,0,0,0,0,64,0
20210126,237,0,225,0,12,0,0,0,0,0,64,0
20210127,238,1,226,1,12,0,0,0,0,0,64,0
20210128,238,0,226,0,12,0,0,0,0,0,64,0
20210129,238,0,227,1,11,-1,0,0,0,0,64,0
20210130,238,0,227,0,11,0,0,0,0,0,64,0
20210131,238,0,227,0,11,0,0,0,0,0,64,0
20210201,239,1,227,0,12,1,0,0,0,0,64,0
20210202,239,0,227,0,12,0,0,0,0,0,64,0
20210203,239,0,227,0,12,0,0,0,0,0,64,0
20210204,239,0,227,0,12,0,0,0,0,0,64,0
20210205,239,0,228,1,11,-1,0,0,0,0,64,0
20210206,239,0,228,0,11,0,0,0,0,0,64,0
20210207,239,0,229,1,10,-1,0,0,0,0,64,0
20210208,239,0,229,0,10,0,0,0,0,0,64,0
20210209,239,0,230,1,9,-1,0,0,0,0,64,0
20210210,239,0,230,0,9,0,0,0,0,0,64,0
20210211,239,0,230,0,9,0,0,0,0,0,64,0
20210212,239,0,231,1,8,-1,0,0,0,0,64,0
20210213,239,0,231,0,8,0,0,0,0,0,64,0
20210214,239,0,231,0,8,0,0,0,0,0,64,0
20210215,239,0,231,0,8,0,0,0,0,0,64,0
20210216,239,0,234,3,5,-3,0,0,0,0,64,0
20210217,239,0,236,2,3,-2,0,0,0,0,64,0
20210218,239,0,236,0,3,0,0,0,0,0,64,0
20210219,239,0,237,1,2,-1,0,0,0,0,64,0
20210220,239,0,237,0,2,0,0,0,0,0,64,0
20210221,239,0,237,0,2,0,0,0,0,0,64,0
20210222,240,1,237,0,3,1,0,0,0,0,64,0
20210223,240,0,237,0,3,0,0,0,0,0,64,0
20210224,240,0,238,1,2,-1,0,0,0,0,64,0
20210225,240,0,238,0,2,0,0,0,0,0,64,0
20210226,240,0,238,0,2,0,0,0,0,0,64,0
20210227,240,0,238,0,2,0,0,0,0,0,64,0
20210228,240,0,238,0,2,0,0,0,0,0,64,0
20210301,240,0,238,0,2,0,0,0,0,0,64,0
20210302,240,0,238,0,2,0,0,0,0,0,64,0
20210303,240,0,238,0,2,0,0,0,0,0,64,0
20210304,240,0,238,0,2,0,0,0,0,0,64,0
20210305,240,0,238,0,2,0,0,0,0,0,64,0
20210306,240,0,238,0,2,0,0,0,0,0,64,0
20210307,240,0,238,0,2,0,0,0,0,0,64,0
20210308,241,1,238,0,3,1,0,0,0,0,64,0
20210309,241,0,239,1,2,-1,0,0,0,0,64,0
20210310,241,0,239,0,2,0,0,0,0,0,64,0
20210311,241,0,239,0,2,0,0,0,0,0,64,0
20210312,241,0,239,0,2,0,0,0,0,0,64,0
20210313,241,0,239,0,2,0,0,0,0,0,64,0
20210314,241,0,239,0,2,0,0,0,0,0,64,0
20210315,241,0,239,0,2,0,0,0,0,0,64,0
20210316,241,0,239,0,2,0,0,0,0,0,64,0
20210317,241,0,239,0,2,0,0,0,0,0,64,0
20210318,241,0,239,0,2,0,0,0,0,0,64,0
20210319,241,0,239,0,2,0,0,0,0,0,64,0
20210320,241,0,240,1,1,-1,0,0,0,0,64,0
20210321,241,0,240,0,1,0,0,0,0,0,64,0
20210322,241,0,240,0,1,0,0,0,0,0,64,0
20210323,241,0,240,0,1,0,0,0,0,0,64,0
20210324,241,0,240,0,1,0,0,0,0,0,64,0
20210325,241,0,240,0,1,0,0,0,0,0,64,0
20210326,241,0,240,0,1,0,0,0,0,0,64,0
20210327,241,0,240,0,1,0,0,0,0,0,64,0
20210328,241,0,240,0,1,0,0,0,0,0,64,0
20210329,241,0,240,0,1,0,0,0,0,0,64,0
20210330,241,0,240,0,1,0,0,0,0,0,64,0
20210331,241,0,240,0,1,0,0,0,0,0,64,0
20210401,241,0,240,0,1,0,0,0,0,0,64,0
20210402,241,0,240,0,1,0,0,0,0,0,64,0
20210403,241,0,240,0,1,0,0,0,0,0,64,0
20210404,241,0,240,0,1,0,0,0,0,0,64,0
20210405,245,4,240,0,5,4,0,0,0,0,64,0
20210406,245,0,240,0,5,0,0,0,0,0,64,0
20210407,245,0,240,0,5,0,0,0,0,0,64,0
20210408,246,1,240,0,6,1,0,0,0,0,64,0
20210409,247,1,240,0,7,1,0,0,0,0,64,0
20210410,248,1,240,0,8,1,0,0,0,0,64,0
20210411,248,0,240,0,8,0,0,0,0,0,64,0
20210412,248,0,240,0,8,0,0,0,0,0,64,0
20210413,248,0,240,0,8,0,0,0,0,0,64,0
20210414,249,1,240,0,9,1,0,0,0,0,64,0
20210415,249,0,240,0,9,0,0,0,0,0,64,0
20210416,249,0,240,0,9,0,0,0,0,0,64,0
20210417,249,0,240,0,9,0,0,0,0,0,64,0
20210418,249,0,240,0,9,0,0,0,0,0,64,0
20210419,249,0,241,1,8,-1,0,0,0,0,64,0
20210420,249,0,241,0,8,0,0,0,0,0,64,0
20210421,249,0,242,1,7,-1,0,0,0,0,64,0
20210422,249,0,242,0,7,0,0,0,0,0,64,0
20210423,249,0,242,0,7,0,0,0,0,0,64,0
20210424,249,0,242,0,7,0,0,0,0,0,64,0
20210425,249,0,242,0,7,0,0,0,0,0,64,0
20210426,249,0,243,1,6,-1,0,0,0,0,64,0
20210427,249,0,243,0,6,0,0,0,0,0,64,0
20210428,250,1,243,0,7,1,0,0,0,0,64,0
20210429,251,1,243,0,8,1,0,0,0,0,64,0
20210430,251,0,243,0,8,0,0,0,0,0,64,0
20210501,251,0,243,0,8,0,0,0,0,0,64,0
20210502,251,0,243,0,8,0,0,0,0,0,64,0
20210503,251,0,243,0,8,0,0,0,0,0,64,0
20210504,251,0,243,0,8,0,0,0,0,0,64,0
20210505,251,0,243,0,8,0,0,0,0,0,64,0
20210506,251,0,243,0,8,0,0,0,0,0,64,0
20210507,251,0,244,1,7,-1,0,0,0,0,64,0
20210508,251,0,244,0,7,0,0,0,0,0,64,0
20210509,251,0,244,0,7,0,0,0,0,0,64,0
20210510,251,0,244,0,7,0,0,0,0,0,64,0
20210511,251,0,244,0,7,0,0,0,0,0,64,0
20210512,251,0,244,0,7,0,0,0,0,0,64,0
20210513,251,0,244,0,7,0,0,0,0,0,64,0
20210514,251,0,244,0,7,0,0,0,0,0,64,0
20210515,251,0,244,0,7,0,0,0,0,0,64,0
20210516,251,0,245,1,6,-1,0,0,0,0,64,0
20210517,251,0,245,0,6,0,0,0,0,0,64,0
20210518,251,0,246,1,5,-1,0,0,0,0,64,0
20210519,251,0,246,0,5,0,0,0,0,0,64,0
20210520,251,0,246,0,5,0,0,0,0,0,64,0
20210521,251,0,247,1,4,-1,0,0,0,0,64,0
20210522,251,0,247,0,4,0,0,0,0,0,64,0
20210523,251,0,247,0,4,0,0,0,0,0,64,0
20210524,253,2,247,0,6,2,0,0,0,0,64,0
20210525,253,0,247,0,6,0,0,0,0,0,64,0
20210526,253,0,247,0,6,0,0,0,0,0,64,0
20210527,253,0,247,0,6,0,0,0,0,0,64,0
20210528,253,0,248,1,5,-1,0,0,0,0,64,0
20210529,253,0,248,0,5,0,0,0,0,0,64,0
20210530,253,0,248,0,5,0,0,0,0,0,64,0
20210531,253,0,248,0,5,0,0,0,0,0,64,0
20210601,253,0,248,0,5,0,0,0,0,0,64,0
20210602,253,0,248,0,5,0,0,0,0,0,64,0
20210603,253,0,250,2,3,-2,0,0,0,0,64,0
20210604,253,0,250,0,3,0,0,0,0,0,64,0
20210605,253,0,250,0,3,0,0,0,0,0,64,0
20210606,253,0,250,0,3,0,0,0,0,0,64,0
20210607,253,0,250,0,3,0,0,0,0,0,64,0
20210608,253,0,250,0,3,0,0,0,0,0,64,0
20210609,253,0,250,0,3,0,0,0,0,0,64,0
20210610,253,0,250,0,3,0,0,0,0,0,64,0
20210611,253,0,250,0,3,0,0,0,0,0,64,0
20210612,253,0,251,1,2,-1,0,0,0,0,64,0
20210613,253,0,252,1,1,-1,0,0,0,0,64,0
20210614,253,0,252,0,1,0,0,0,0,0,64,0
20210615,253,0,252,0,1,0,0,0,0,0,64,0
20210616,253,0,252,0,1,0,0,0,0,0,64,0
20210617,253,0,252,0,1,0,0,0,0,0,64,0
20210618,253,0,252,0,1,0,0,0,0,0,64,0
20210619,253,0,252,0,1,0,0,0,0,0,64,0
20210620,253,0,252,0,1,0,0,0,0,0,64,0
20210621,253,0,252,0,1,0,0,0,0,0,64,0
20210622,253,0,252,0,1,0,0,0,0,0,64,0
20210623,253,0,252,0,1,0,0,0,0,0,64,0
20210624,253,0,252,0,1,0,0,0,0,0,64,0
20210625,253,0,252,0,1,0,0,0,0,0,64,0
20210626,253,0,252,0,1,0,0,0,0,0,64,0
20210627,253,0,252,0,1,0,0,0,0,0,64,0
20210628,253,0,252,0,1,0,0,0,0,0,64,0
20210629,253,0,252,0,1,0,0,0,0,0,64,0
20210630,253,0,252,0,1,0,0,0,0,0,64,0
20210701,253,0,252,0,1,0,0,0,0,0,64,0
20210702,253,0,252,0,1,0,0,0,0,0,64,0
20210703,253,0,252,0,1,0,0,0,0,0,64,0
20210704,253,0,252,0,1,0,0,0,0,0,64,0
20210705,253,0,252,0,1,0,0,0,0,0,64,0
20210706,253,0,252,0,1,0,0,0,0,0,64,0
20210707,253,0,252,0,1,0,0,0,0,0,64,0
20210708,253,0,252,0,1,0,0,0,0,0,64,0
20210709,253,0,252,0,1,0,0,0,0,0,64,0
20210710,253,0,252,0,1,0,0,0,0,0,64,0
20210711,253,0,252,0,1,0,0,0,0,0,64,0
20210712,253,0,252,0,1,0,0,0,0,0,64,0
20210713,253,0,252,0,1,0,0,0,0,0,64,0
20210714,253,0,252,0,1,0,0,0,0,0,64,0
20210715,253,0,252,0,1,0,0,0,0,0,64,0
20210716,253,0,253,1,0,-1,0,0,0,0,64,0
20210717,253,0,253,0,0,0,0,0,0,0,64,0
20210718,253,0,253,0,0,0,0,0,0,0,64,0
20210719,253,0,253,0,0,0,0,0,0,0,64,0
20210720,253,0,253,0,0,0,0,0,0,0,64,0
20210721,253,0,253,0,0,0,0,0,0,0,64,0
20210722,253,0,253,0,0,0,0,0,0,0,64,0
20210723,253,0,253,0,0,0,0,0,0,0,64,0
20210724,253,0,253,0,0,0,0,0,0,0,64,0
20210725,253,0,253,0,0,0,0,0,0,0,64,0
20210726,253,0,253,0,0,0,0,0,0,0,64,0
20210727,253,0,253,0,0,0,0,0,0,0,64,0
20210728,253,0,253,0,0,0,0,0,0,0,64,0
20210729,253,0,253,0,0,0,0,0,0,0,64,0
20210730,253,0,253,0,0,0,0,0,0,0,64,0
20210731,253,0,253,0,0,0,0,0,0,0,64,0
20210801,253,0,253,0,0,0,0,0,0,0,64,0
20210802,253,0,253,0,0,0,0,0,0,0,64,0
20210803,253,0,253,0,0,0,0,0,0,0,64,0
20210804,254,1,253,0,1,1,0,0,0,0,64,0
20210805,254,0,253,0,1,0,0,0,0,0,64,0
20210806,254,0,253,0,1,0,0,0,0,0,64,0
20210807,254,0,253,0,1,0,0,0,0,0,64,0
20210808,254,0,253,0,1,0,0,0,0,0,64,0
20210809,254,0,253,0,1,0,0,0,0,0,64,0
20210810,254,0,253,0,1,0,0,0,0,0,64,0
20210811,254,0,253,0,1,0,0,0,0,0,64,0
20210812,254,0,253,0,1,0,0,0,0,0,64,0
20210813,254,0,253,0,1,0,0,0,0,0,64,0
20210814,254,0,253,0,1,0,0,0,0,0,64,0
20210815,255,1,253,0,2,1,0,0,0,0,64,0
20210816,255,0,253,0,2,0,0,0,0,0,64,0
20210817,255,0,253,0,2,0,0,0,0,0,64,0
20210818,255,0,254,1,1,-1,0,0,0,0,64,0
20210819,255,0,254,0,1,0,0,0,0,0,64,0
20210820,255,0,254,0,1,0,0,0,0,0,64,0
20210821,255,0,254,0,1,0,0,0,0,0,64,0
20210822,256,1,254,0,2,1,0,0,0,0,64,0
20210823,256,0,254,0,2,0,0,0,0,0,64,0
20210824,256,0,254,0,2,0,0,0,0,0,64,0
20210825,256,0,254,0,2,0,0,0,0,0,64,0
20210826,256,0,254,0,2,0,0,0,0,0,64,0
20210827,258,2,254,0,4,2,0,0,0,0,64,0
